Gg, Gg, Gg, Gg^Br|, Gg^Br|, Qlf, Qlf, Qlf, Qlf, Qlf, Qlf^Br/, Gg^Br/, Gg^Br/, Gg^Br/, Gs^Fds, Gs^Fds, Gs^Fds, Gs^Fds, Gs^Fds, Gg, Gs^Fds, Gs^Fds, Gs^Fds, Gs^Fds, Gs^Fds, Gs^Fds, Gs^Fds, Gs^Fds, Gs^Fds, Gs^Fds, Gs^Fds, Gg, Gg, Gg, Gg, Gg, Gg, Gg, Gg, Gg, Gs^Fds, Gg, Gs^Fds, Gg, Gg, Gg
Gg, Gg, Gg, Gg^Br|, Gg^Br|, Qlf, Qlf, Qlf, Qlf^Br/, Qlf^Br/, Ql^Br\, Gg^Br/, Ql, Ql, Ql, Gs^Fds, Gg^Br\, Gs^Fds, Gs^Fds, Gs^Fds, Gs^Fds, Gs^Fds, Gs^Fds, Gs^Fds, Gs^Fds, Gs^Fds, Gs^Fds, Gs^Fds, Gs^Fds, Gs^Fds, Gs^Fds, Gs^Fds, Gs^Fds, Gg, Qlf, Gg, Gs^Fds, Gs^Fds, Gs^Fds, Gs^Fds, Gs^Fds, Gs^Fds, Gs^Fds, Gg, Gg, Gg
Gg, Gg, Gg, Gg^Br|, Gg^Br|, Qlf, Qlf^Br/, Qlf^Br/, Qlf^Br/, Qlf^Br|, Qlf^Br|, Ql, Ql, Ql, Gg^Br/, Gg^Br/, Gg^Br/, Gg^Br\, Gg^Br\, Gs^Fds, Gg^Br/, Gs^Fds, Gs^Fds, Gs^Fds, Gs^Fds, Gs^Fds, Gs^Fds, Gs^Fds, Gs^Fds, Gs^Fds, Gs^Fds, Gs^Fds, Gs^Fds, Gs^Fds, Gg^Br|, Gg, Gg, Gs^Fds, Gs^Fds, Gs^Fds, Gs^Fds, Gs^Fds, Gs^Fds, Gg, Gg, Gg
Gg, Gg, Gg, Gg^Br|, Gg^Br|, Qlf^Br/, Qlf^Br/, Qlf^Br/, Qlf^Br\, Qlf^Br|, Gg^Br|, Gg^Br\, Gg^Br\, Gg^Br/, Gg^Br/, Gg^Br\, Gg^Br\, Gg^Br/, Gg^Br\, Gg^Br\, Gg^Br\, Gg^Br\, Gg^Br\, Gs^Fds, Gs^Fds, Gs^Fds, Gs^Fds, Gs^Fds, Gs^Fds, Gs^Fds, Gg^Br/, Gg^Br/, Ql^Br\, Gs^Fds, Gg^Br|, Gg^Br\, Gg, Gs^Fds, Gs^Fds, Gs^Fds, Gs^Fds, Gs^Fds, Gs^Fds, Gg, Gg, Gg
Gg^Br\, Qlf, Qlf, Gg^Br|, Gg^Br|, Qlf^Br/, Qlf^Br\, Qlf^Br\, Qlf^Br/, Qlf^Br/, Gg^Br|, Gg^Br|, Gg^Br|, Gg^Br\, Gg^Br\, Gg^Br/, Gg^Br/, Gg^Br\, Gg^Br\, Gg^Br\, Gg^Br\, Gg^Br\, Gg^Br\, Gg^Br\, Ql^Br\, Gs^Fds, Gs^Fds, Gs^Fds, Gg^Br/, Gg^Br/, Ql^Br\, Ql^Br\, Gg^Br/, Gg^Br/, Gg^Br|, Gg^Br|, Gg, Gs^Fds, Gs^Fds, Gs^Fds, Gs^Fds, Gs^Fds, Gs^Fds, Gg, Gg, Gg
Qlf, Qlf^Br\, Gg^Br\, Gg^Br\, Gg^Br\, Qlf^Br\, Qlf^Br/, Qlf^Br/, Qlf^Br\, Qlf^Br\, Gg^Br|, Gg^Br\, Gg^Br\, Gg^Br|, Gg^Br|, Gg^Br\, Gg^Br\, Gg^Br/, Gg^Br\, Gg^Br\, Gg^Br/, Gg^Br/, Gg^Br/, Gg^Br/, Gg^Br\, Ql^Br\, Ql^Br\, Gg^Br/, Ql^Br\, Ql^Br\, Gg^Br/, Gg^Br/, Gg^Br|, Gg^Br|, Gg^Br/, Gg^Br|, Gg, Gs^Fds, Gs^Fds, Gs^Fds, Gs^Fds, Gs^Fds, Gs^Fds, Gg, Gg, Gg
Gg^Br\, Gg, Gg^Br/, Gg^Br/, Gg^Br/, Gg^Br\, Gg^Br\, Qlf^Br\, Gg^Br/, Gg^Br/, Qlf, Gg^Br|, Gg^Br|, Gg^Br\, Gg^Br/, Gg^Br/, Gg^Br/, Gg^Br\, Gg^Br\, Gg^Br\, Gg^Br/, Gg^Br/, Icr, Gg^Br\, Gg^Br\, Gg^Br\, Gg^Br\, Ql^Br\, Gg^Br/, Gg^Br/, Gg^Br|, Gs^Br/, Gg^Br/, Gg^Br/, Mm^Xm, Gg^Br\, Gg^Br\, Gg, Gg, Gg, Gg, Gs^Fds, Gg^Br/, Gg^Br\, Gg^Br/, Gg
Qlf, Gg^Br\, Gg^Br/, Gg^Br/, Gg^Br\, Gg^Br\, Gg^Br\, Gg^Br/, Qlf, Qlf, Gg^Br/, Gg^Br|, Gg^Br|, Gg^Br|, Gg^Br/, Gg^Br|, Gg^Br/, Gg^Br/, Gg^Br/, Gg^Br/, Icr^Br|, Icr^Br\, Icr^Br\, Icr^Br|, Gg^Br\, Gg^Br\, Gg^Br/, Gg^Br\, Gs^Br/, Gs^Br/, Gg^Br/, Gg^Br/, Xue, Xue, Xue, Mm^Xm, Mm^Xm, Gg^Br\, Gg^Br\, Gg, Gg^Br/, Gg^Br/, Gg, Gg, Wwrg, Gg
Gg^Br/, Gg^Br/, Qlf, Qlf, Qlf, Gg^Br\, Gg^Br\, Gg^Br\, Gg^Br/, Gg^Br/, Gg^Br\, Gg^Br|, Gg^Br|, Gg^Br/, Gg^Br|, Gg^Br|, Gg^Br/, Gg^Br/, Gg^Br/, Gg^Br\, Gg^Br|, Icr, Gg^Br/, Icr^Br|, Icr^Br|, Gg^Br/, Icr^Br/, Icr^Br/, Gg^Br/, Gg^Br/, Xue, Xue, Uue, Uh, Xue, Xu, Xu, Mm^Xm, Mm^Xm, Gg^Br\, Gs^Fds, Gs^Fds, Gg, Wwrg, Wog, Gg
Gg^Br\, Qlf, Qlf, Qlf, Qlf, Qlf, Gg^Br|, Gg^Br\, Gg^Br\, Gg^Br\, Gg^Br\, Gg^Br/, Gg^Br|, Gg^Br|, Gg^Br|, Gg^Br|, Gg^Br/, Gg^Br/, Gg^Br/, Gg^Br|, Gg^Br\, Gg^Br/, Icr, Icr^Br|, Icr^Br|, Icr^Br/, Gg^Br/, Gg^Br/, Gg, Xue, Uue, Uue, Uh, Uue, Uh, Ai, Xu, Xu, Uu^Ufi, Mm^Xm, Gs^Fds, Gs^Fds, Gg, Wog, Wog, Gg
Gg, Gg^Br\, Gg^Br\, Qlf, Qlf, Qlf, Gg^Br|, Qlf, Gg^Br|, Gg^Br\, Gg^Br\, Gg^Br|, Gg^Br\, Gg^Br|, Gg^Br/, Gg^Br/, Gg^Br/, Gg^Br/, Gg^Br|, Gg^Br|, Icr^Br|, Gg^Br|, Icr^Br\, Icr^Br|, Gg^Br\, Gg^Br/, Gg^Br/, Gg^Br\, Gg^Br/, Xue, Uue, Uue, Uue, Uue, Xue, Xue, Uu^Ufi, Uu^Ufi, Uu^Ufi, Mm^Xm, Gs^Fds, Gs^Fds, Gg, Wog, Wog, Gg
Gg, Gg, Gg^Br|, Gg^Br\, Gg^Br\, Qlf, Gg^Br\, Qlf, Gg^Br|, Gg^Br|, Qlf, Gg^Br\, Gg^Br/, Gg^Br/, Gg^Br/, Gg^Br/, Gg^Br|, Gg^Br/, Gg^Br|, Gg^Br|, Gg^Br|, Icr^Br|, Gg, Gg^Br\, Gg^Br/, Gg^Br/, Gg^Br/, Gg^Br/, Gg, Xue, Xue, Uue, Uu^Ufi, Xue, Uu^Ufi, Uu^Ufi, Uu^Ufi, Uu^Ufi, Mm^Xm, Mm^Xm, Gs^Fds, Gs^Fds, Wo, Wo, Wwt, Gg
Gg, Gg, Gg^Br|, Gg^Br|, Gg^Br|, Gg^Br\, Gg^Br\, Gg^Br\, Gg^Br\, Gg^Br|, Gg^Br/, Gg^Br/, Gg^Br/, Gg^Br/, Gg^Br/, Gg^Br/, Gg^Br|, Gg^Br/, Gg^Br|, Gg^Br|, Gg^Br|, Icr^Br|, Gg, Gg, Gg^Br/, Gg^Br/, Gg, Gg^Dr, Gg, Gg, Mm^Xm, Xue, Uu^Ufi, Uu^Ufi, Uu^Ufi, Uu^Ufi, Mm^Xm, Mm, Gs^Fds, Gs^Fds, Gs^Fds, Gs^Fds, Wwt, Wo, Wo, Gg
Gg, Gg, Gg^Br|, Gg^Br|, Gg^Br|, Gg^Br\, Gg^Br/, Gg^Br\, Gg^Br\, Gg^Br|, Gg^Br\, Gg^Br\, Gg^Br/, Gg^Br/, Gg^Br/, Gg^Br/, Gg^Br|, Gg^Br/, Gg^Br/, Gg^Br|, Gg^Br|, Icr^Br|, Gg^Br/, Gg^Br/, Gg^Br|, Gg, Gg, Gg, Xom, Gg, Mm^Xm, Uu^Ufi, Gg, Uu^Ufi, Mm^Xm, Mm^Xm, Gs^Fds, Gs^Fds, Gs^Fds, Gs^Fds, Gs^Fds, Gs^Fds, Wog, Wwg, Wo, Gg
Gg, Gg, Gg^Br|, Gg^Br|, Gg^Br|, Gg^Br/, Gg^Br/, Gg^Br/, Gg^Br/, Gg^Br\, Gg^Br\, Gg^Br\, Gg^Br\, Gg^Br/, Gg^Br/, Gg^Br/, Gg^Br\, Gg^Br/, Gg^Br/, Gg^Br/, Gg^Br/, Gg^Br/, Gg, Gg, Gg^Br|, Gg, Xom, Xom, Gg, Xom, Xom, Mm^Xm, Mm^Xm, Gg, Gd^Fts, Gs^Fds, Gs^Fds, Gs^Fds, Gs^Fds, Gs^Fds, Wog, Wog, Wwrg, Wog, Wo, Gg
Gg, Gg, Gg^Br|, Gg^Br|, Gg^Br|, Gg^Br/, Gg^Br/, Gg^Br/, Gg^Br/, Gg^Br|, Gg^Br/, Gg^Br\, Gg^Br/, Gg^Br/, Gg^Br/, Gg^Br/, Aa^Fpa, Gg^Br\, Gg^Br/, Gg^Br/, Gg^Br\, Gg^Br\, Gg^Br\, Gg, Gg^Br|, Xom, Gg, Gg, Gg, Gg, Xom, Xom, Gg, Gg, Gd^Fts, Gd^Fts, Gd^Fts, Gs^Fds, Wwt, Wwt, Wog, Wot, Wog, Wo, Gg, Gg
Gg, Gg, Gg^Br|, Gg^Br|, Gg^Br/, Gg^Br/, Gg^Br/, Gg^Br/, Gg^Br/, Gg^Br|, Gg^Br/, Gg^Br/, Gg^Br/, Gg^Br/, Aa^Fpa, Aa^Fpa, Gg^Br/, Gg^Br/, Aa^Fpa, Gg^Br\, Gg^Br\, Gg^Br\, Gg^Br\, Gg^Br\, Gg^Br|, Gg^Br\, Gg^Br\, Gg, Xom, Xom, Gg, Gg^Br/, Xom, Xom, Xom, Gd^Fts, Wwt, Sm, Wo, Wot, Wwrg, Wwrg, Wot, Gg, Gg, Gg
Gg, Gg, Gg^Br|, Gg^Br|, Gg^Br|, Gg^Br/, Gg^Br/, Gg^Br/, Gg, Gg^Br\, Gg^Br/, Gg^Br\, Gs^Br\, Aa^Fpa, Gg^Br/, Aa^Fpa, Aa^Fpa, Aa^Fpa, Aa^Fpa, Aa^Fpa, Aa^Fpa, Gg^Br\, Gg^Br\, Gg^Br\, Gg^Br/, Gg^Br\, Xom, Gg^Br\, Gg^Br\, Gg, Xom, Xom, Xom, Xom, Xom, Xom, Xom, Wwt, Wwt, Wwrg, Wwt, Wot, Wwt, Gg, Gg, Gg
Gg, Gg, Gg^Br|, Gg^Br|, Gg^Br|, Gg^Br\, Gg^Br|, Gg^Br\, Gg^Br/, Gg^Br/, Gg, Gg, Gg, Gg^Br\, Gs^Br\, Aa^Fpa, Aa^Fpa, Aa^Fpa, Aa^Fpa, Aa^Fpa, Aa^Fpa, Xom, Xom, Gg^Br\, Gg^Br\, Gg, Gg, Gg, Xom, Gg^Br\, Gg^Br\, Xom, Gs^Fds, Gs^Fds, Icr, Xom, Xom, Xom, Xom, Wwt, Xom, Xom, Xom, Wwt, Gg, Gg
Gg^Br\, Gg, Gg^Br|, Gg^Br|, Gg^Br|, Gg^Br\, Gg^Br|, Gg^Br|, Gg, Gg, Gg, Mv, Mv, Gg, Gg, Gg^Br\, Gg^Br\, Aa^Fpa, Aa^Fpa, Aa^Fpa, Aa^Fpa, Aa^Fpa, Xom, Xom, Xom, Gg^Br\, Gg^Br\, Xom, Xom, Xom, Icr, Gg, Icr^Ecf, Gs^Fds, Gs^Fds, Icr, Gs^Fds, Xom, Xom, Xom, Xom, Qlf, Qlf, Xom, Xom, Gg
Gg, Gg^Br\, Gg^Br\, Gg^Br\, Gg^Br\, Gg, Gg^Br/, Gg^Br|, Gg, Ql, Gg^Br\, Gg, Qlf, Qlf, Qlf, Gg, Gg, Gg^Br\, Gg^Br\, Aa^Fpa, Xom, Xom, Qlf, Qlf, Ai, Xom, Xom, Gg^Br\, Icr^Br\, Icr, Gs^Fds, Gs^Fds, Gs^Fds, Gs^Fds, Gs^Fds, Gs^Fds, Gs^Fds, Gs^Fds, Icn, Xom, Ai, Rr, Rr, Qlf, Qlf, Xom
Gg, Gg, Gg, Gg^Br\, Gg^Br\, Gg^Br\, Gg^Br/, Gg^Br/, Gg, Gg, Gg^Br/, Gg^Br\, Gg^Br\, Ql, Ql, Qlf, Qlf, Gg, Gg, Gg^Br\, Gg^Br\, Gg, Qlf, Qlf, Ai, Ai, Icn, Gs^Fds, Gs^Efs, Gs^Br\, Gs^Br\, Aa^Fpa, Gs^Fds, Icn^Ecf, Gs^Fds, Icn^Ecf, Gs^Fds, Icn, Urc, Urc, Ai, Rr, Rr, Rr, Rr, Xom
Gg, Gg, Gg, Gg, Gg, Gg^Br\, Gg^Br\, Gg, Gg^Br/, Gg^Br/, Gg^Br\, Gg^Br|, Gg^Br\, Gg^Br|, Ql, Ql, Ql, Ql, Ql, Gg, Xom, Gg^Br\, Qlf, Qlf, Ai, Urc, Urc, Gs^Fds, Gs^Fds, Gs^Efs, Gs^Efs, Gs^Br\, Gs^Br\, Gs^Efs, Gs^Efs, Gs^Efs, Aa, Ai, Rr, Ai, Gg, Rr, Rr, Xom, Rr, Gg
Gg, Gg, Gg, Gg, Gg, Gg^Br|, Gg^Br/, Gg^Br/, Gg, Gg^Br|, Gg^Br\, Gg^Br|, Gg^Br\, Gg^Br|, Ql, Ql, Ql, Ql, Ql, Ql, Chr, Xom, Xom, Qlf, Qlf, Ai, Ai, Urc, Urc, Gs^Fds, Gs^Fds, Gs^Efs, Urc, Gs^Fds, Gg, Gg, Aa, Ai, Rr, Rr, Rr, Rr, Xom, Xom, Rr, Gg
Gg, Gg, Gg, Gg, Gg, Gg^Br|, Gg^Br|, Gg, Ql, Gg^Br|, Gg^Br\, Gg^Br|, Gg^Br\, Gg^Br|, Ql, Ql, Ke, Ql, Ql, Kud, Chr, Ql, Ql, Xom, Xom, Qlf, Qlf, Ai, Aa^Vla, Ai, Ai, Urc, Aa, Aa^Vla, Aa, Aa, Aa, Xom, Rr, Rr, Xom, Xom, Rr, Rr, Gg, Gg
Gg, Gg, Gg, Gg, Gg, Gg^Br|, Ql, Gg, Ql, Ql, Gg, Gg^Br\, Gg^Br\, Gg^Br|, Ql, Ql, Gg, Ql, Ql, Kud, Ql, Ql, Ql, Gg, Xom, Qlf, Ai, Ai, Ai, Ai, Ai^Efs, Ai, Aa^Vla, Aa, Aa, Aa, Aa, Qlf, Qlf, Rr, Rr, Rr, Rr, Gg, Gg, Gg
Gg, Gg, Gg, Gg, Gg, Gg^Br|, Ql, Ql, Gs^Vh, Ke, Ke, Gg, Gg, Gg^Br|, Ke, Ql, Gg, Gg, Gg, Kud, Ql, Ql, Ql, Xom, Qlf, Qlf, Aa, Aa^Vla, Aa, Rrc^Vhca, Rrc^Vhca, Ai, Rrc^Vhca, Aa, Aa^Vha, Aa^Vla, Aa^Vha, Qlf, Qlf, Xom, Gg, Rr, Rr, Rr, Rr, Gg
Gg, Gg, Gg, Gg, Gg, Gg^Bw\, Ql^Bw\, Gs^Vh, Gs^Vh, Ql^Eff, Ql^Eff, Ke, Gg, Gg^Br\, Gg^Br\, Ke, Ke, Gg, Ql, Kud, Ql, Ql, Ql, Xom, Qlf, Rrc^Vhca, Aa, Rrc^Vhca, Aa, Rrc^Vhca, Aa^Ecf, Rrc^Vhca, Rrc^Vhca, Aa^Vha, Aa^Vha, Aa^Vha, Qlf, Qlf, Xom, Xom, Re, Gg, Gg, Rr, Gg, Gg
Gg, Gg, Gg, Gg, Ql^Bw\, Ql, Gs^Vh, Gs^Vh, Ql^Bw\, Ql, Ql, Ql^Eff, Ql^Eff, Ke, Ke, Qxu^Br\, Qxu^Br\, Ke, Kv, Chr, Ql, Ql, Ql, Xom, Xom, Qlf, Qlf, Qlf, Qlf, Aa, Rrc^Vhca, Ai, Aa^Vha, Gs^Fds, Qlf, Qlf, Qlf, Qlf, Qlf, Xom, Re, Mv, Gg, Rr, Gg, Gg
Gg, Gg, Ql, Ql^Bw\, Ql^Bw\, Ql^Bw\, Ql^Bw\, Ql^Bw\, Ql^Bw\, Ql^Bw\, Ql^Bw\, Ql, Ql, Ql^Eff, Ql^Eff, Ke, Ke, Qxu^Br\, Qxu^Br\, Kv, Kv, Ql, Ql, Ql, Ql, Xom, Ql, Ql, Ql, Qlf, Ai, Aa^Vha, Ai, Qxu^Bh\, Qxu^Bh\, Qlf, Qlf, Qlf, Qlf, Xom, Gg, Mv, Gs, Rr, Gg, Gg
Gg, Gg, Ql, Ql, Ql, Ql^Bw\, Ql^Bw\, Ql^Bw\, Ql^Bw\, Ql^Bw\, Ql^Bw\, Ql^Bw\, Ql^Bw\, Ql, Ql, Ql^Eff, Ql^Eff, Ke, Ke, Qxu^Br\, Qxu^Br\, Kv, Kdr, Ql, Ql, Ql, Ql, Ql, Ql, Ql, Xom, Ai, Xom, Xom, Xom, Qxu^Bh\, Qxu^Bh\, Qlf, Xom, Xom, Re, Mv, Gs, Rr, Gs, Gg
Gg, Gg, Ql, Ql, Ql, Ql, Ql, Ql^Bw\, Ql^Bw\, Ql^Bw\, Ql^Bw\, Ql^Bw\, Ql^Bw\, Ql^Bw\, Ql^Bw\, Ql, Ql, Ql^Eff, Ql^Eff, Ke, Gg, Qxu^Br\, Qxu^Br\, Kdr, Ql, Ql, Ql, Ql, Ql, Ql, Ql, Ai, Hhd, Xom, Xom, Qlf, Qlf, Qxu^Bh\, Qxu^Bh\, Xom, Gg, Mv, Rr, Rr, Gs, Gg
Gg, Gg, Gg, Ql, Ql, Ql, Ql, Ql, Ql, Ql^Bw\, Ql^Bw\, Ql^Bw\, Ql^Bw\, Ql^Bw\, Gg, Ql^Bw\, Gg, Gg, Ql, Ql^Eff, Ql^Eff, Kdr, Kdr, Kdr, Ql, Ql, Ql, Ql, Ql, Ql, Ql, Hhd, Hhd, Hhd, Qlf, Qlf, Qlf, Qlf, Xom, Qxu^Bh\, Rr, Gg, Rr, Rr, Gg, Gg
Gg, Gg, Gg, Gg, Gg, Gg, Gg, Ql, Gg, Ql, Gg, Gg^Bw\, Gg, Gg, Gg, Gg, Gg, Gg, Gg, Ql, Ql^Eff, Ql^Eff, Gg, Ql, Ql, Ql, Ql, Ql, Ql, Ql, Ql, Hhd, Hhd, Hhd, Hhd, Gg, Gg, Gg, Gg, Gg, Gg, Rr, Gg, Gg, Gg, Gg
Gg, Gg, Gg, Gg, Gg, Gg, Gg, Gg, Gg, Gg, Gg, Gg, Gg, Gg, Gg, Gg, Gg, Gg, Gg, Gg, Gg, Gg, Gg, Gg, Gg, Ql, Gg, Hhd, Hhd, Hhd, Hhd, Hhd, Hhd, Hhd, Gg, Gg, Gg, Gg, Gg, Gg, Gg, Gg, Gg, Gg, Gg, Gg
