Gg, Gg, Gg, Gg, Gg, Gg, Mm^Xm, Gg, Mm^Xm, Gg, Gg, Gg, Gg, Mm^Xm, Mm^Xm, Mm^Xm, Mm^Xm, Gg, Gg, Gg, Gg, Gg, Mm^Xm, Gg, Gg, Gg, Gg, Md^Xm, Gg, Gg, Mm^Xm, Gg, Gg, Mm^Xm, Gg, Gg, Gg, Gg, Gg, Gg, Gg, Gg, Xom, Xom, Xom, Gg, Gg, Gg, Gg, Gg, Gg, Gg, Gg, Gg, Gg, Gg, Gg, Gg, Gg, Gg, Gg, Gg, Gg, Gg, Gg, Gg, Gg, Gg, Gg, Gg, Gg, Gg, Gg, Gg, Gg, Gg, Gg, Gg, Gg, Gg, Xom, Xom, Xuc, Mm^Xm, Gg, Gg, Gg
Gg, Mm^Xm, Gg, Mm^Xm, Gg, Mm^Xm, Gg, Mm^Xm, Mm^Xm, Mm^Xm, Mm^Xm, Mm^Xm, Mm^Xm, Mm^Xm, Gg, Gg, Gg, Mm^Xm, Mm^Xm, Gg, Gg, Mm^Xm, Mm^Xm, Gg, Gg, Gg, Mm^Xm, Gg, Gg, Gg, Mm^Xm, Gg, Gg, Mm^Xm, Gg, Gg, Gg, Gg, Xom, Xom, Xom, Xom, Gg, Gg, Gg, Xom, Xom, Gg, Gg, Gg, Gg, Gg, Gg, Gg, Gg, Gg, Gg, Gg, Gg, Gg, Gg, Gg, Gg, Gg, Gg, Gg, Gg, Gg, Gg, Gg, Gg, Gg, Gg, Gg, Gg, Gg, Gg, Gg, Gg, Xom, Uu, Uu, Uu, Xuc, Gg, Gg, Gg
Gg, Mm^Xm, 1 Gg, Mm^Xm, Gg, Mm^Xm, Gg, Mm^Xm, Mm^Xm, Gg, Gg, Gg, Mm^Xm, Gg, Gg, Mm^Xm, Gg, Gg, Mm^Xm, Gg, Gg, Gg, Gg, Mm^Xm, Gg, Gg, Gg, Md^Xm, Gg, Gg, Mm^Xm, Gg, Gg, Mm^Xm, Gg, Gg, Xom, Xom, Gg, Gg, Gg, Gg, Gg, Xom, Xom, Gg, Gg, Xom, Xom, Gg, Gg, Gg, Gg, Xom, Gg, Gg, Gg, Gg, Gg, Gg, Xom, Xom, Xom, Gg, Gg, Gg, Gg, Gg, Gg, Gg, Gg, Gg, Gg, Gg, Gg, Gg, Gg, Gg, Gg, Xom, Uu, Xom, Xom, Xom, Gg, Gg, Gg
Gg, Mm^Xm, Gg, Mm^Xm, Gg, Mm^Xm, Gg, Gg, Mm^Xm, Gg, Mm^Xm, Gg, Mm^Xm, Gg, Gg, Mm^Xm, Mm^Xm, Gg, Gg, Mm^Xm, Gg, Mm^Xm, Mm^Xm, Gg, Gg, Gg, Gg, Md^Xm, Gg, Gg, Mm^Xm, Gg, Gg, Mm^Xm, Xom, Xom, Gg, Gg, Gg, Gg, Gg, Gg, Gg, Gg, Gg, Xom, Gg, Gg, Gg, Xom, Xom, Xom, Gg, Gg, Gg, Xom, Gg, Gg, Xom, Xom, Uu, Xom, Uu, Xom, Xom, Gg, Gg, Gg, Gg, Gg, Gg, Gg, Gg, Gg, Gg, Gg, Xom, Gg, Xom, Xom, Uue, Xom, Xom, Gg, Gg, Gg, Gg
Gg, Mm^Xm, Gg, Gg, Mm^Xm, Gg, Gg, Gg, Mm^Xm, Gg, Mm^Xm, Gg, Gg, Mm^Xm, Gg, Gg, Gg, Mm^Xm, Gg, Mm^Xm, Gg, Mm^Xm, Mm^Xm, Gg, Gg, Gg, Gg, Mm^Xm, Md^Xm, Gg, Mm^Xm, Gg, Gg, Mm^Xm, Gg, Gg, Gg, Gg, Gg, Gg, Gg, Md^Xm, Md^Xm, Gg, Gg, Gg, Gg, Xom, Gg, Xom, Gg, Gg, Gg, Gg, Gg, Gg, Xom, Xom, Xom, Uu, Xom, Uu, Xom, Uu, Xom, Xom, Xom, Gg, Gg, Gg, Xom, Gg, Xom, Xom, Xom, Xom, Uu, Xom, Uue, Uue, Xom, Xom, Xom, Gg, Gg, Gg, Gg
Gg, Mm^Xm, Gg, Mm^Xm, Mm^Xm, Mm^Xm, Gg, Mm^Xm, Mm^Xm, Gg, Mm^Xm, Gg, Gg, Mm^Xm, Mm^Xm, Gg, Mm^Xm, Mm^Xm, Gg, Mm^Xm, Mm^Xm, Gg, Gg, Mm^Xm, Mm^Xm, Gg, Gg, Mm^Xm, Gg, Gg, Gg, Gg, Gg, Mm^Xm, Gg, Gg, Mm^Xm, Gg, Gg, Mm^Xm, Mm^Xm, Gg, Gg, Md^Xm, Gg, Gg, Gg, Xom, Gg, Xom, Gg, Xom, Xom, Gg, Xom, Gg, Gg, Xom, Xom, Uu, Xom, Xom, Uue, Uu, Xom, Xom, Uu, Xom, Xom, Xom, Uu, Xom, Uu, Uu, Uu, Uu, Uu, Uu, Uue, Xom, Uue, Xom, Xom, Gg, Gg, Gg, Gg
Mm^Xm, Mm^Xm, Gg, Gg, Mm^Xm, Gg, Gg, Gg, Mm^Xm, Gg, Gg, Mm^Xm, Gg, Mm^Xm, Gg, Gg, Mm^Xm, Gg, Gg, Gg, Gg, Mm^Xm, Gg, Gg, Mm^Xm, Gg, Gg, Mm^Xm, Gg, Gg, Mm^Xm, Gg, Gg, Gg, Mm^Xm, Mm^Xm, Gg, Md^Xm, Mm^Xm, Gg, Gg, Mm^Xm, Gg, Md^Xm, Gg, Gg, Gg, Xom, Gg, Gg, Xom, Gg, Gg, Xom, Gg, Xom, Xom, Gg, Xom, Uu, Xom, Uue, Xom, Uu, Uh, Xom, Uu, Uu, Xom, Uu, Uu, Uu, Uu, Uu, Uu, Uu, Uue, Uue, Uu, Uue, Uue, Uue, Xom, Xom, Gg, Gg, Gg
Mm^Xm, Gg, Mm^Xm, Gg, Mm^Xm, Gg, Gg, Mm^Xm, Gg, Gg, Gg, Mm^Xm, Gg, Mm^Xm, Gg, Gg, Mm^Xm, Gg, Gg, Mm^Xm, Gg, Gg, Mm^Xm, Gg, Mm^Xm, Gg, Gg, Mm^Xm, Gg, Gg, Mm^Xm, Gg, Gg, Mm^Xm, Gg, Gg, Mm^Xm, Gg, Mm^Xm, Gg, Gg, Mm^Xm, Gg, Md^Xm, Gg, Gg, Gg, Xom, Gg, Gg, Xom, Xom, Xom, Gg, Xom, Gg, Xom, Gg, Xom, Xom, Uue, Uue, Xom, Uue, Uu, Xom, Xom, Uu, Uu, Xom, Uu, Uu, Uu, Uu, Uu, Uu, Uu, Uue, Uue, Uue, Xom, Xom, Xom, Xom, Gg, Gg, Gg
Mm^Xm, Gg, Gg, Gg, Mm^Xm, Gg, Gg, Gg, Mm^Xm, Mm^Xm, Mm^Xm, Gg, Mm^Xm, Mm^Xm, Gg, Gg, Mm^Xm, Gg, Gg, Mm^Xm, Gg, Mm^Xm, Gg, Mm^Xm, Gg, Gg, Gg, Mm^Xm, Gg, Gg, Mm^Xm, Gg, Gg, Gg, Mm^Xm, Mm^Xm, Gg, Gg, Mm^Xm, Gg, Gg, Mm^Xm, Gg, Md^Xm, Gg, Gg, Gg, Gg, Xom, Xom, Xom, Xom, Gg, Xom, Gg, Gg, Xom, Gg, Xom, Xom, Xom, Xom, Uue, Uue, Xom, Uu, Xom, Uu, Uu, Xom, Uu, Uu, Uu, Uu, Uu, Uu, Uu, Uue, Uu, Uu, Xom, Xom, Xom, Xom, Gg, Gg, Gg
Gg, Mm^Xm, Mm^Xm, Gg, Gg, Mm^Xm, Mm^Xm, Mm^Xm, Gg, Gg, Gg, Gg, Mm^Xm, Gg, Gg, Gg, Mm^Xm, Gg, Mm^Xm, Mm^Xm, Gg, Gg, Gg, Gg, Mm^Xm, Gg, Mm^Xm, Mm^Xm, Gg, Gg, Mm^Xm, Gg, Gg, Mm^Xm, Mm^Xm, Gg, Gg, Mm^Xm, Gg, Gg, Mm^Xm, Mm^Xm, Gg, Md^Xm, Gg, Xom, Xom, Xom, Xom, Xom, Gg, Gg, Xom, Gg, Xom, Xom, Gg, Gg, Xoi, Xom, Uue, Uue, Xom, Xom, Uu, Uu, Xom, Uu, Uu, Uu, Uu, Uu, Uu, Uu, Uu, Uu, Xom, Xom, Xom, Xom, Xom, Xom, Xom, Xom, Xom, Gg, Gg
Gg, Mm^Xm, Mm^Xm, Gg, Gg, Gg, Gg, Gg, Mm^Xm, Gg, Gg, Gg, Gg, Gg, Gg, Mm^Xm, Gg, Gg, Mm^Xm, Mm^Xm, Gg, Mm^Xm, Mm^Xm, Gg, Gg, Mm^Xm, Gg, Gg, Gg, Gg, Mm^Xm, Gg, Gg, Gg, Gg, Mm^Xm, Mm^Xm, Gg, Gg, Gg, Mm^Xm, Gg, Gg, Md^Xm, Gg, Gg, Gg, Xom, Gg, Gg, Xom, Xom, Gg, Gg, Xue, Gg, Xom, Xom, Uue, Uue, Xom, Xom, Xom, Xom, Xom, Xom, Uu, Uu, Uu, Xom, Xom, Uu, Xom, Uu, Xom, Xom, Xom, Xom, Xom, Xom, Xoi, Xom, Xom, Xom, Gg, Gg, Gg
Gg, Gg, Gg, Mm^Xm, Mm^Xm, Gg, Gg, Gg, Gg, Gg, Gg, Gg, Gg, Gg, Gg, Gg, Gg, Gg, Mm^Xm, Gg, Gg, Gg, Mm^Xm, Mm^Xm, Mm^Xm, Gg, Mm^Xm, Gg, Mm^Xm, Mm^Xm, Gg, Gg, Gg, Md^Xm, Gg, Gg, Gg, Mm^Xm, Md^Xm, Gg, Gg, Gg, Md^Xm, Md^Xm, Gg, Gg, Xom, Gg, Xom, Xom, Gg, Gg, Xom, Xom, Uu, Xom, Uu, Uu, Uu, Xom, Uu, Uu, Xom, Uu, Xom, Uu, Uu, Uu, Xom, Xom, Xom, Xom, Xom, Xom, Xom, Xom, Xom, Xom, Uue, Uue, Xoi, Xoi, Gg, Gg, Gg, Gg, Gg
Gg, Gg, Gg, Gg, Gg, Mm^Xm, Mm^Xm, Mm^Xm, Mm^Xm, Mm^Xm, Mm^Xm, Gg, Mm^Xm, Gg, Mm^Xm, Gg, Mm^Xm, Mm^Xm, Gg, Gg, Mm^Xm, Mm^Xm, Gg, Mm^Xm, Mm^Xm, Mm^Xm, Gg, Mm^Xm, Gg, Mm^Xm, Gg, Gg, Md^Xm, Gg, Gg, Gg, Gg, Gg, Gg, Md^Xm, Gg, Gg, Md^Xm, Gg, Md^Xm, Md^Xm, Gg, Xom, Gg, Gg, Xom, Xom, Uu, Uu, Uu, Uu, Xom, Uu, Uu, Xom, Xom, Uu, Uu, Uu, Uu, Uu, Uu, Xom, Xom, Xom, Xom, Xom, Xom, Uue, Xom, Xom, Uue, Uue, Xue, Xue, Gg, Gg, Gg, Gg, Gg, Gg, Gg
Gg, Gg, Gg, Gg, Gg, Gg, Md^Xm, Mm^Xm, Gg, Gg, Gg, Mm^Xm, Gg, Mm^Xm, Gg, Mm^Xm, Gg, Gg, Gg, Gg, Qlf, Gg, Gg, Gg, Gg, Gg, Gg, Gg, Gg, Gg, Md^Xm, Gg, Gg, Gg, Gg, Md^Xm, Gg, Gg, Gg, Md^Xm, Md^Xm, Md^Xm, Gg, Gg, Md^Xm, Gg, Mm^Xm, Gg, Xom, Xom, Xom, Xom, Xom, Uu, Xom, Xom, Xom, Xom, Uu, Uu, Uu, Xom, Uu, Uu, Xom, Xom, Xom, Uue, Uue, Uue, Uue, Xom, Uue, Uue, Uue, Uue, Uue, Xue, Xue, Xue, Gg, Gg, Gg, Gg, Gg, Gg, Gg
Md^Xm, Gg, Gg, Gg, Gg, Md^Xm, Gg, Gg, Md^Xm, Md^Xm, Md^Xm, Gg, Gg, Gg, Md^Xm, Gg, Gg, Gg, Mm^Xm, Gg, Mm^Xm, Gg, Md^Xm, Md^Xm, Md^Xm, Md^Xm, Md^Xm, Gg, Md^Xm, Gg, Gg, Gg, Gg, Md^Xm, Gg, Gg, Gg, Md^Xm, Gg, Gg, Gg, Gg, Md^Xm, Md^Xm, Gg, Gg, Gg, Gg, Gg, Xom, Xom, Xom, Xom, Xom, Xom, Xom, Uu, Uu, Xom, Uu, Xom, Xom, Uu, Xom, Uue, Uue, Uue, Uue, Uue, Uue, Uue, Uue, Uue, Uue, Uue, Uue, Xoc, Xue, Gg, Gg, Gg, Gg, Gg, Gg, Gg, Gg, Gg
Gg, Md^Xm, Md^Xm, Gg, Gg, Md^Xm, Md^Xm, Gg, Gg, Gg, Md^Xm, Gg, Gg, Md^Xm, Gg, Gg, Mm^Xm, Mm^Xm, Mm^Xm, Mm^Xm, Gg, Md^Xm, Gg, Gg, Gg, Gg, Md^Xm, Gg, Md^Xm, Gg, Gg, Gg, Md^Xm, Md^Xm, Gg, Gg, Md^Xm, Gg, Md^Xm, Gg, Gg, Md^Xm, Gg, Md^Xm, Gg, Gg, Mm^Xm, Gg, Gg, Gg, Gg, Xom, Xom, Xom, Xom, Xom, Xom, Xom, Xom, Uu, Xom, Xom, Uu, Xom, Xom, Xom, Xom, Uue, Uue, Uue, Uue, Uue, Uue, Uue, Uue, Uue, Xu, Xoc, Gg, Gg, Gg, Gg, Gg, Gg, Gg, Gg, Gg
Gg, Gg, Gg, Md^Xm, Gg, Gg, Md^Xm, Md^Xm, Gg, Gg, Md^Xm, Gg, Md^Xm, Md^Xm, Md^Xm, Gg, Gg, Gg, Gg, Gg, Gg, Gg, Md^Xm, Gg, Gg, Md^Xm, Gg, Gg, Md^Xm, Md^Xm, Md^Xm, Md^Xm, Gg, Gg, Gg, Gg, Gg, Gg, Gg, Gg, Md^Xm, Md^Xm, Gg, Md^Xm, Gg, Gg, Gg, Gg, Mm^Xm, Gg, Xom, Xom, Xom, Xom, Xom, Xom, Xom, Xom, Xom, Uu, Xom, Xom, Uu, Xom, Xom, Xom, Xom, Xom, Xom, Uue, Uue, Uue, Uue, Uue, Xue, Xuc, Gg, Gg, Gg, Gg, Gg, Gg, Gg, Gg, Gg, Gg, Gg
Md^Xm, Gg, Gg, Md^Xm, Gg, Gg, Gg, Md^Xm, Gg, Gg, Md^Xm, Gg, Gg, Gg, Gg, Gg, Md^Xm, Gg, Gg, Md^Xm, Md^Xm, Gg, Gg, Md^Xm, Md^Xm, Gg, Md^Xm, Md^Xm, Gg, Gg, Gg, Gg, Md^Xm, Gg, Md^Xm, Md^Xm, Md^Xm, Gg, Md^Xm, Gg, Md^Xm, Gg, Gg, Md^Xm, Gg, Gg, Mm^Xm, Mm^Xm, Gg, Gg, Xom, Xom, Xom, Xom, Xom, Xom, Xom, Xom, Xom, Uu, Uu, Uu, Uu, Xom, Xom, Xom, Xom, Xom, Xom, Uue, Uue, Uue, Xom, Xos, Gg, Gg, Gg, Gg, Gg, Gg, Gg, Gg, Gg, Gg, Gg, Gg, Gg
Gg, Gg, Md^Xm, Md^Xm, Gg, Gg, Gg, Md^Xm, Gg, Gg, Md^Xm, Md^Xm, Gg, Md^Xm, Md^Xm, Gg, Gg, Md^Xm, Md^Xm, Gg, Gg, Md^Xm, Md^Xm, Gg, Gg, Md^Xm, Gg, Gg, Md^Xm, Md^Xm, Md^Xm, Md^Xm, Gg, Gg, Md^Xm, Gg, Gg, Md^Xm, Gg, Md^Xm, Gg, Gg, Gg, Md^Xm, Gg, Mm^Xm, Gg, Gg, Gg, Gg, Xom, Xom, Xom, Xom, Xom, Xom, Xom, Xom, Xom, Gg, Xom, Uu, Xom, Xom, Xom, Xom, Xom, Xom, Uue, Uue, Uue, Xoi, Uue, Xom, Gg, Gg, Gg, Gg, Gg, Gg, Gg, Gg, Gg, Gg, Gg, Gg, Gg
Gg, Md^Xm, Gg, Gg, Md^Xm, Gg, Gg, Md^Xm, Gg, Gg, Gg, Md^Xm, Md^Xm, Gg, Gg, Md^Xm, Md^Xm, Gg, Gg, Md^Xm, Gg, Gg, Gg, Md^Xm, Md^Xm, Gg, Md^Xm, Md^Xm, Gg, Gg, Gg, Gg, Gg, Gg, Md^Xm, Gg, Gg, Gg, Gg, Gg, Gg, Gg, Gg, Md^Xm, Gg, Mm^Xm, Gg, Mm^Xm, Gg, Gg, Xom, Xom, Gg^Ii, Xom, Gg^Ii, Xom, Xom, Xom, Xom, Gg, Xom, Xom, Xom, Xom, Xom, Xom, Xom, Xom, Xoc, Xoc, Uue, Uue, Xom, Xom, Gg, Gg, Gg, Gg, Gg, Gg, Gg, Gg, Gg, Gg, Gg, Gg, Gg
Gg, Md^Xm, Gg, Md^Xm, Gg, Md^Xm, Md^Xm, Md^Xm, Md^Xm, Gg, Gg, Gg, Gg, Md^Xm, Md^Xm, Gg, Gg, Md^Xm, Gg, Md^Xm, Gg, Md^Xm, Gg, Gg, Gg, Md^Xm, Md^Xm, Gg, Gg, Gg, Gg, Gg, Gg, Gg, Rr^Pr\o, Rr^Pr\o, Md^Xm, Gg, Gg, Gg, Gg, Gg, Md^Xm, Md^Xm, Gg, Mm^Xm, Gg, Mm^Xm, Gg, Gg, Xom, Xom, Gg^Ii, Gg^Ii, Gg^Ii, Gg^Ii, Gg^Ii, Gg^Ii, Gg^Ii, Gg, Xom, Xom, Xom, Xom, Xom, Xom, Xom, Uue, Uue, Uue, Uue, Uue, Xom, Gg, Gg, Gg, Gg, Gg, Gg, Gg, Gg, Gg, Gg, Gg, Gg, Gg, Gg
Gg, Md^Xm, Md^Xm, Gg, Gg, Md^Xm, Md^Xm, Gg, Gg, Md^Xm, Md^Xm, Gg, Gg, Gg, Md^Xm, Gg, Gg, Md^Xm, Gg, Md^Xm, Gg, Md^Xm, Gg, Gg, Md^Xm, Gg, Gg, Md^Xm, Md^Xm, Gg, Gg, Gg, Gg, Rr^Pr\o, Gg, Gg, Xue, Gg, Gg, Gg, Md^Xm, Gg, Md^Xm, Gg, Gg, Mm^Xm, Gg, Mm^Xm, Gg, Gg, Xom, Xom, Gg^Ii, Gg^Ii, Gg^Ii, Gg^Ii, Gg^Ii, Gg^Ii, Gg^Ii, Xom, Gg^Ii, Mm^Xm, Mm^Xm, Gg, Gg, Gg, Xom, Uue, Uue, Uue, Uue, Uue, Xom, Gg, Gg, Gg, Gg, Gg, Gg, Gg, Gg, Gg, Gg, Gg, Gg, Gg, Gg
Gg, Gg, Gg, Md^Xm, Gg, Gg, Gg, Md^Xm, Md^Xm, Gg, Md^Xm, Md^Xm, Gg, Gg, Md^Xm, Gg, Gg, Md^Xm, Md^Xm, Gg, Md^Xm, Md^Xm, Gg, Gg, Md^Xm, Gg, Md^Xm, Gg, Gg, Md^Xm, Gg, Gg, Gg, Gg, Xos, Xue, Gg, Md^Xm, Md^Xm, Md^Xm, Gg, Md^Xm, Gg, Gg, Gg, Mm^Xm, Gg, Mm^Xm, Gg, Gg, Gg, Xom, Xom, Gg^Ii, Gg^Ii, Gg^Ii, Gg^Ii, Gg^Ii, Gg^Ii, Gg^Ii, Gg^Ii, Gg^Ii, Mm^Xm, Gg, Gg, Gg, Xom, Uue, Uue, Uue, Xom, Xom, Gg, Gg, Gg, Gg, Gg, Gg, Gg, Gg, Gg, Gg, Gg, Gg, Gg, Gg, Gg
Gg, Gg, Gg, Md^Xm, Gg, Md^Xm, Gg, Md^Xm, Gg, Gg, Md^Xm, Md^Xm, Gg, Gg, Gg, Md^Xm, Md^Xm, Gg, Gg, Md^Xm, Gg, Gg, Md^Xm, Md^Xm, Gg, Gg, Gg, Gg, Md^Xm, Gg, Gg, Gg, Xom, Xom, Gg, Gg, Gg, Mm^Xm, Gg, Gg, Gg, Gg, Mm^Xm, Mm^Xm, Gg, Mm^Xm, Gg, Mm^Xm, Gg, Gg, Gg, Xom, Xom, Xom, Xom, Gg^Ii, Xom, Gg^Ii, Xom, Xom, Uu^Ufi, Uu^Ufi, Mm^Xm, Gg, Gg, Gg, Gg, Xom, Xom, Xom, Gg, Gg, Gg, Gg, Gg, Gg, Gg, Gg, Gg, Gg, Gg, Gg, Gg, Gg, Gg, Gg, Gg
Gg, Gg, Gg, Md^Xm, Gg, Md^Xm, Gg, Md^Xm, Gg, Md^Xm, Gg, Md^Xm, Md^Xm, Md^Xm, Md^Xm, Gg, Gg, Md^Xm, Md^Xm, Gg, Md^Xm, Md^Xm, Md^Xm, Gg, Gg, Md^Xm, Md^Xm, Gg, Gg, Md^Xm, Gg, Gg, Xom, Gg, Gg, Gg, Mm^Xm, Mm^Xm, Gg, Gg, Mm^Xm, Mm^Xm, Iwr, Mm^Xm, Gg, Mm^Xm, Gg, Mm^Xm, Mm^Xm, Gg, Gg, Gg, Gg, Mm^Xm, Gg, Xom, Gg, Xom, Gg, Xom, Mm^Xm, Uu^Ufi, Mm^Xm, Gg, Gg, Gg, Gg, Gg, Gg, Gg, Gg, Gg, Gg, Gg, Gg, Gg, Gg, Gg, Gg, Gg, Gg, Gg, Gg, Gg, Gg, Gg, Gg
Gg, Gg, Md^Xm, Md^Xm, Gg, Md^Xm, Gg, Md^Xm, Gg, Md^Xm, Md^Xm, Gg, Gg, Gg, Gg, Md^Xm, Md^Xm, Gg, Gg, Md^Xm, Gg, Md^Xm, Gg, Gg, Gg, Md^Xm, Gg, Gg, Md^Xm, Md^Xm, Gg, Gg, Xom, Gg, Gg, Gg, Mm^Xm, Gg, Gg, Gg, Gg, Iwr, Iwr, Mm^Xm, Gg, Mm^Xm, Mm^Xm, Gg, Gg, Mm^Xm, Mm^Xm, Gg, Gg, Mm^Xm, Gg, Gg, Gg, Gg, Gg, Gg, Gg, Gg, Mm^Xm, Gg, Gg, Gg, Gg, Gg, Gg, Gg, Gg, Gg, Gg, Gg, Gg, Gg, Gg, Gg, Gg, Gg, Gg, Gg, Gg, Gg, Gg, Gg, Gg
Gg, Gg, Md^Xm, Gg, Md^Xm, Md^Xm, Gg, Md^Xm, Md^Xm, Gg, Md^Xm, Md^Xm, Md^Xm, Md^Xm, Md^Xm, Gg, Gg, Md^Xm, Md^Xm, Gg, Md^Xm, Gg, Gg, Gg, Md^Xm, Md^Xm, Gg, Gg, Md^Xm, Gg, Gg, Gg, Xom, Gg, Gg, Gg, Gg, Mm^Xm, Mm^Xm, Mm^Xm, Mm^Xm, Mm^Xm, Iwr, Mm^Xm, Xos, Gg, Gg, Mm^Xm, Mm^Xm, Gg, Gg, Mm^Xm, Mm^Xm, Gg, Mm^Xm, Gg, Mm^Xm, Mm^Xm, Mm^Xm, Mm^Xm, Mm^Xm, Mm^Xm, Gg, Gg, Gg, Gg, Gg, Gg, Gg, Gg, Gg, Gg, Gg, Gg, Gg, Gg, Gg, Gg, Gg, Gg, Gg, Gg, Gg, Gg, Gg, Gg, Gg
Gg, Gg, Md^Xm, Gg, Md^Xm, Gg, Md^Xm, Md^Xm, Gg, Gg, Gg, Md^Xm, Gg, Md^Xm, Md^Xm, Gg, Gg, Gg, Gg, Md^Xm, Md^Xm, Md^Xm, Md^Xm, Md^Xm, Gg, Gg, Md^Xm, Md^Xm, Gg, Gg, Xom, Xom, Gg, Gg, Mm^Xm, Gg, Gg, Gg, Xos, Xos, Iwr, Iwr, Iwr, Iwr, Iwr, Xos, Xos, Gg, Gg, Mm^Xm, Gg, Gg, Gg, Mm^Xm, Gg, Mm^Xm, Gg, Gg, Gg, Gg, Gg, Gg, Gg, Gg, Gg, Gg, Gg, Gg, Gg, Gg, Gg, Gg, Gg, Gg, Gg, Gg, Gg, Gg, Gg, Gg, Gg, Gg, Gg, Gg, Gg, Gg, Gg
Gg, Md^Xm, Gg, Gg, Md^Xm, Gg, Gg, Gg, Md^Xm, Gg, Gg, Gg, Gg, Gg, Gg, Md^Xm, Md^Xm, Gg, Gg, Gg, Gg, Gg, Gg, Gg, Gg, Gg, Md^Xm, Gg, Gg, Xom, Gg, Gg, Mm^Xm, Mm^Xm, Gg, Mm^Xm, Mm^Xm, Gg, Xos, Iwr, Iwr, Xos, Xos, Iwr, Xos, Xos, Xos, Gg, Gg, Mm^Xm, Gg, Gg, Gg, Gg, Gg, Gg, Gg, Gg, Gg, Gg, Gg, Gg, Gg, Gg, Gg, Gg, Gg, Gg, Gg, Gg, Gg, Gg, Gg, Gg, Gg, Gg, Gg, Gg, Gg, Gg, Gg, Gg, Gg, Gg, Gg, Gg, Gg
Gg, Md^Xm, Gg, Md^Xm, Gg, Md^Xm, Md^Xm, Md^Xm, Gg, Md^Xm, Gg, Md^Xm, Md^Xm, Gg, Gg, Gg, Gg, Md^Xm, Md^Xm, Gg, Md^Xm, Gg, Md^Xm, Md^Xm, Md^Xm, Md^Xm, Mm^Xm, Gg, Gg, Gg, Gg, Mm^Xm, Gg, Gg, Mm^Xm, Gg, Gg, Gg, Xos, Iwr, Iwr, Xos, Xos, Xos, Iwr, Iwr, Xos, Gg, Gg, Mm^Xm, Gg, Gg, Gg, Gg, Gg, Gg, Gg, Gg, Gg, Gg, Gg, Gg, Gg, Gg, Gg, Gg, Gg, Gg, Gg, Gg, Gg, Gg, Gg, Gg, Gg, Gg, Gg, Gg, Gg, Gg, Gg, Gg, Gg, Gg, Gg, Gg, Gg
Gg, Md^Xm, Md^Xm, Gg, Md^Xm, Gg, Gg, Gg, Md^Xm, Gg, Md^Xm, Md^Xm, Gg, Md^Xm, Md^Xm, Gg, Md^Xm, Gg, Gg, Md^Xm, Md^Xm, Md^Xm, Gg, Gg, Gg, Gg, Gg, Mm^Xm, Mm^Xm, Mm^Xm, Mm^Xm, Gg, Mm^Xm, Mm^Xm, Mm^Xm, Mm^Xm, Gg, Gg, Xos, Iwr, Iwr, Iwr, Iwr, Iwr, Xos, Xos, Gg, Gg, Mm^Xm, Mm^Xm, Gg, Gg, Gg, Gg, Gg, Gg, Gg, Gg, Gg, Gg, Gg, Gg, Gg, Gg, Gg, Gg, Gg, Gg, Gg, Gg, Gg, Gg, Gg, Gg, Gg, Gg, Gg, Gg, Gg, Gg, Gg, Gg, Gg, Gg, Gg, Gg, Gg
Gg, Gg, Gg, Md^Xm, Gg, Md^Xm, Md^Xm, Md^Xm, Md^Xm, Md^Xm, Gg, Gg, Gg, Gg, Gg, Gg, Md^Xm, Gg, Gg, Gg, Gg, Gg, Ms^Xm, Ms^Xm, Ms^Xm, Ms^Xm, Ms^Xm, Gg, Gg, Gg, Gg, Mm^Xm, Mm^Xm, Mm^Xm, Mm^Xm, Mm^Xm, Gg, Gg, Gg, Xos, Xos, Xos, Xos, Xos, Gg, Gg, Mm^Xm, Mm^Xm, Gg, Gg, Gg, Gg, Gg, Gg, Gg, Gg, Gg, Gg, Gg, Gg, Gg, Gg, Gg, Gg, Gg, Gg, Gg, Gg, Gg, Gg, Gg, Gg, Gg, Gg, Gg, Gg, Gg, Gg, Gg, Gg, Gg, Gg, Gg, Gg, Gg, Gg, Gg
Gg, Gg, Gg, Gg, Gg, Gg, Gg, Gg, Gg, Gg, Gg, Gg, Gg, Md^Xm, Gg, Md^Xm, Gg, Ms^Xm, Ms^Xm, Gg, Ms^Xm, Ms^Xm, Gg, Gg, Gg, Gg, Gg, Ms^Xm, Gg, Gg, Gg, Gg, Mm^Xm, Mm^Xm, Gg, Gg, Mm^Xm, Mm^Xm, Mm^Xm, Gg, Gg, Gg, Gg, Gg, Mm^Xm, Mm^Xm, Gg, Gg, Gg, Gg, Gg, Gg, Gg, Gg, Gg, Gg, Gg, Gg, Gg, Gg, Gg, Gg, Gg, Gg, Gg, Gg, Gg, Gg, Gg, Gg, Gg, Gg, Gg, Gg, Gg, Gg, Gg, Gg, Gg, Gg, Gg, Gg, Gg, Gg, Gg, Gg, Gg
Gg, Gg, Gg, Gg, Gg, Gg, Gg, Gg, Gg, Gg, Gg, Gg, Gg, Gg, Gg, Gg, Gg, Gg, Gg, Ms^Xm, Gg, Gg, Gg, Gg, Gg, Gg, Gg, Gg, Gg, Ms^Xm, Gg, Gg, Mm^Xm, Gg, Gg, Mm^Xm, Gg, Mm^Xm, Gg, Mm^Xm, Mm^Xm, Mm^Xm, Mm^Xm, Mm^Xm, Gg, Gg, Gg, Gg, Gg, Gg, Gg, Gg, Gg, Gg, Gg, Gg, Gg, Gg, Gg, Gg, Gg, Gg, Gg, Gg, Gg, Gg, Gg, Gg, Gg, Gg, Gg, Gg, Gg, Gg, Gg, Gg, Gg, Gg, Gg, Gg, Gg, Gg, Gg, Gg, Gg, Gg, Gg
Gg, Gg, Gg, Gg, Gg, Gg, Gg, Gg, Gg, Gg, Gg, Gg, Gg, Gg, Gg, Gg, Gg, Gg, Gg, Gg, Gg, Gg, Gg, Gg, Gg, Gg, Gg, Gg, Gg, Gg, Gg, Gg, Gg, Mm^Xm, Mm^Xm, Gg, Gg, Gg, Gg, Gg, Gg, Gg, Gg, Gg, Gg, Gg, Gg, Gg, Gg, Gg, Gg, Gg, Gg, Gg, Gg, Gg, Gg, Gg, Gg, Gg, Gg, Gg, Gg, Gg, Gg, Gg, Gg, Gg, Gg, Gg, Gg, Gg, Gg, Gg, Gg, Gg, Gg, Gg, Gg, Gg, Gg, Gg, Gg, Gg, Gg, Gg, Gg
Gg, Gg, Gg, Gg, Gg, Gg, Gg, Gg, Gg, Gg, Gg, Gg, Gg, Gg, Gg, Gg, Gg, Gg, Gg, Gg, Gg, Gg, Gg, Gg, Gg, Gg, Gg, Gg, Gg, Gg, Gg, Gg, Gg, Gg, Gg, Mm^Xm, Gg, Gg, Gg, Gg, Gg, Gg, Gg, Gg, Gg, Gg, Gg, Gg, Gg, Gg, Gg, Gg, Gg, Gg, Gg, Gg, Gg, Gg, Gg, Gg, Gg, Gg, Gg, Gg, Gg, Gg, Gg, Gg, Gg, Gg, Gg, Gg, Gg, Gg, Gg, Gg, Gg, Gg, Gg, Gg, Gg, Gg, Gg, Gg, Gg, Gg, Gg
Gg, Gg, Gg, Gg, Gg, Gg, Gg, Gg, Gg, Gg, Gg, Gg, Gg, Gg, Gg, Gg, Gg, Gg, Gg, Gg, Gg, Gg, Gg, Gg, Gg, Gg, Gg, Gg, Gg, Gg, Gg, Gg, Gg, Gg, Gg, Gg, Gg, Gg, Gg, Gg, Gg, Gg, Gg, Gg, Gg, Gg, Gg, Gg, Gg, Gg, Gg, Gg, Gg, Gg, Gg, Gg, Gg, Gg, Gg, Gg, Gg, Gg, Gg, Gg, Gg, Gg, Gg, Gg, Gg, Gg, Gg, Gg, Gg, Gg, Gg, Gg, Gg, Gg, Gg, Gg, Gg, Gg, Gg, Gg, Gg, Gg, Gg
Gg, Gg, Gg, Gg, Gg, Gg, Gg, Gg, Gg, Gg, Gg, Gg, Gg, Gg, Gg, Gg, Gg, Gg, Gg, Gg, Gg, Gg, Gg, Gg, Gg, Gg, Gg, Gg, Gg, Gg, Gg, Gg, Gg, Gg, Gg, Gg, Gg, Gg, Gg, Gg, Gg, Gg, Gg, Gg, Gg, Gg, Gg, Gg, Gg, Gg, Gg, Gg, Gg, Gg, Gg, Gg, Gg, Gg, Gg, Gg, Gg, Gg, Gg, Gg, Gg, Gg, Gg, Gg, Gg, Gg, Gg, Gg, Gg, Gg, Gg, Gg, Gg, Gg, Gg, Gg, Gg, Gg, Gg, Gg, Gg, Gg, Gg
Gg, Gg, Gg, Gg, Gg, Gg, Gg, Gg, Gg, Gg, Gg, Gg, Gg, Gg, Gg, Gg, Gg, Gg, Gg, Gg, Gg, Gg, Gg, Gg, Gg, Gg, Gg, Gg, Gg, Gg, Gg, Gg, Gg, Gg, Gg, Gg, Gg, Gg, Gg, Gg, Gg, Gg, Gg, Gg, Gg, Gg, Gg, Gg, Gg, Gg, Gg, Gg, Gg, Gg, Gg, Gg, Gg, Gg, Gg, Gg, Gg, Gg, Gg, Gg, Gg, Gg, Gg, Gg, Gg, Gg, Gg, Gg, Gg, Gg, Gg, Gg, Gg, Gg, Gg, Gg, Gg, Gg, Gg, Gg, Gg, Gg, Gg
Gg, Gg, Gg, Gg, Gg, Gg, Gg, Gg, Gg, Gg, Gg, Gg, Gg, Gg, Gg, Gg, Gg, Gg, Gg, Gg, Gg, Gg, Gg, Gg, Gg, Gg, Gg, Gg, Gg, Gg, Gg, Gg, Gg, Gg, Gg, Gg, Gg, Gg, Gg, Gg, Gg, Gg, Gg, Gg, Gg, Gg, Gg, Gg, Gg, Gg, Gg, Gg, Gg, Gg, Gg, Gg, Gg, Gg, Gg, Gg, Gg, Gg, Gg, Gg, Gg, Gg, Gg, Gg, Gg, Gg, Gg, Gg, Gg, Gg, Gg, Gg, Gg, Gg, Gg, Gg, Gg, Gg, Gg, Gg, Gg, Gg, Gg
Gg, Gg, Gg, Gg, Gg, Gg, Gg, Gg, Gg, Gg, Gg, Gg, Gg, Gg, Gg, Gg, Gg, Gg, Gg, Gg, Gg, Gg, Gg, Gg, Gg, Gg, Gg, Gg, Gg, Gg, Gg, Gg, Gg, Gg, Gg, Gg, Gg, Gg, Gg, Gg, Gg, Gg, Gg, Gg, Gg, Gg, Gg, Gg, Gg, Gg, Gg, Gg, Gg, Gg, Gg, Gg, Gg, Gg, Gg, Gg, Gg, Gg, Gg, Gg, Gg, Gg, Gg, Gg, Gg, Gg, Gg, Gg, Gg, Gg, Gg, Gg, Gg, Gg, Gg, Gg, Gg, Gg, Gg, Gg, Gg, Gg, Gg
Gg, Gg, Gg, Gg, Gg, Gg, Gg, Gg, Gg, Gg, Gg, Gg, Gg, Gg, Gg, Gg, Gg, Gg, Gg, Gg, Gg, Gg, Gg, Gg, Gg, Gg, Gg, Gg, Gg, Gg, Gg, Gg, Gg, Gg, Gg, Gg, Gg, Gg, Gg, Gg, Gg, Gg, Gg, Gg, Gg, Gg, Gg, Gg, Gg, Gg, Gg, Gg, Gg, Gg, Gg, Gg, Gg, Gg, Gg, Gg, Gg, Gg, Gg, Gg, Gg, Gg, Gg, Gg, Gg, Gg, Gg, Gg, Gg, Gg, Gg, Gg, Gg, Gg, Gg, Gg, Gg, Gg, Gg, Gg, Gg, Gg, Gg
Gg, Gg, Gg, Gg, Gg, Gg, Gg, Gg, Gg, Gg, Gg, Gg, Gg, Gg, Gg, Gg, Gg, Gg, Gg, Gg, Gg, Gg, Gg, Gg, Gg, Gg, Gg, Gg, Gg, Gg, Gg, Gg, Gg, Gg, Gg, Gg, Gg, Gg, Gg, Gg, Gg, Gg, Gg, Gg, Gg, Gg, Gg, Gg, Gg, Gg, Gg, Gg, Gg, Gg, Gg, Gg, Gg, Gg, Gg, Gg, Gg, Gg, Gg, Gg, Gg, Gg, Gg, Gg, Gg, Gg, Gg, Gg, Gg, Gg, Gg, Gg, Gg, Gg, Gg, Gg, Gg, Gg, Gg, Gg, Gg, Gg, Gg
Gg, Gg, Gg, Gg, Gg, Gg, Gg, Gg, Gg, Gg, Gg, Gg, Gg, Gg, Gg, Gg, Gg, Gg, Gg, Gg, Gg, Gg, Gg, Gg, Gg, Gg, Gg, Gg, Gg, Gg, Gg, Gg, Gg, Gg, Gg, Gg, Gg, Gg, Gg, Gg, Gg, Gg, Gg, Gg, Gg, Gg, Gg, Gg, Gg, Gg, Gg, Gg, Gg, Gg, Gg, Gg, Gg, Gg, Gg, Gg, Gg, Gg, Gg, Gg, Gg, Gg, Gg, Gg, Gg, Gg, Gg, Gg, Gg, Gg, Gg, Gg, Gg, Gg, Gg, Gg, Gg, Gg, Gg, Gg, Gg, Gg, Gg
Gg, Gg, Gg, Gg, Gg, Gg, Gg, Gg, Gg, Gg, Gg, Gg, Gg, Gg, Gg, Gg, Gg, Gg, Gg, Gg, Gg, Gg, Gg, Gg, Gg, Gg, Gg, Gg, Gg, Gg, Gg, Gg, Gg, Gg, Gg, Gg, Gg, Gg, Gg, Gg, Gg, Gg, Gg, Gg, Gg, Gg, Gg, Gg, Gg, Gg, Gg, Gg, Gg, Gg, Gg, Gg, Gg, Gg, Gg, Gg, Gg, Gg, Gg, Gg, Gg, Gg, Gg, Gg, Gg, Gg, Gg, Gg, Gg, Gg, Gg, Gg, Gg, Gg, Gg, Gg, Gg, Gg, Gg, Gg, Gg, Gg, Gg
Gg, Gg, Gg, Gg, Gg, Gg, Gg, Gg, Gg, Gg, Gg, Gg, Gg, Gg, Gg, Gg, Gg, Gg, Gg, Gg, Gg, Gg, Gg, Gg, Gg, Gg, Gg, Gg, Gg, Gg, Gg, Gg, Gg, Gg, Gg, Gg, Gg, Gg, Gg, Gg, Gg, Gg, Gg, Gg, Gg, Gg, Gg, Gg, Gg, Gg, Gg, Gg, Gg, Gg, Gg, Gg, Gg, Gg, Gg, Gg, Gg, Gg, Gg, Gg, Gg, Gg, Gg, Gg, Gg, Gg, Gg, Gg, Gg, Gg, Gg, Gg, Gg, Gg, Gg, Gg, Gg, Gg, Gg, Gg, Ms^Xm, Ms^Xm, Ms^Xm
Gg, Gg, Gg, Gg, Gg, Gg, Gg, Gg, Gg, Gg, Gg, Gg, Gg, Gg, Gg, Gg, Gg, Gg, Gg, Gg, Gg, Gg, Gg, Gg, Gg, Gg, Gg, Gg, Gg, Gg, Gg, Gg, Gg, Gg, Gg, Gg, Gg, Gg, Gg, Gg, Gg, Gg, Gg, Gg, Gg, Gg, Gg, Gg, Gg, Gg, Gg, Gg, Gg, Gg, Gg, Gg, Gg, Gg, Gg, Gg, Gg, Gg, Gg, Gg, Gg, Gg, Gg, Gg, Gg, Gg, Gg, Gg, Gg, Gg, Gg, Gg, Gg, Gg, Gg, Gg, Gg, Gg, Gg, Gg, Ms^Xm, 2 Gg, Ms^Xm
Gg, Gg, Gg, Gg, Gg, Gg, Gg, Gg, Gg, Gg, Gg, Gg, Gg, Gg, Gg, Gg, Gg, Gg, Gg, Gg, Gg, Gg, Gg, Gg, Gg, Gg, Gg, Gg, Gg, Gg, Gg, Gg, Gg, Gg, Gg, Gg, Gg, Gg, Gg, Gg, Gg, Gg, Gg, Gg, Gg, Gg, Gg, Gg, Gg, Gg, Gg, Gg, Gg, Gg, Gg, Gg, Gg, Gg, Gg, Gg, Gg, Gg, Gg, Gg, Gg, Gg, Gg, Gg, Gg, Gg, Gg, Gg, Gg, Gg, Gg, Gg, Gg, Gg, Gg, Gg, Gg, Gg, Gg, Gg, Gg, Ms^Xm, Gg
Gg, Gg, Gg, Gg, Gg, Gg, Gg, Gg, Gg, Gg, Gg, Gg, Gg, Gg, Gg, Gg, Gg, Gg, Gg, Gg, Gg, Gg, Gg, Gg, Gg, Gg, Gg, Gg, Gg, Gg, Gg, Gg, Gg, Gg, Gg, Gg, Gg, Gg, Gg, Gg, Gg, Gg, Gg, Gg, Gg, Gg, Gg, Gg, Gg, Gg, Gg, Gg, Gg, Gg, Gg, Gg, Gg, Gg, Gg, Gg, Gg, Gg, Gg, Gg, Gg, Gg, Gg, Gg, Gg, Gg, Gg, Gg, Gg, Gg, Gg, Gg, Gg, Gg, Gg, Gg, Gg, Gg, Gg, Gg, Gg, Gg, Gg
Gg, Gg, Gg, Gg, Gg, Gg, Gg, Gg, Gg, Gg, Gg, Gg, Gg, Gg, Gg, Gg, Gg, Gg, Gg, Gg, Gg, Gg, Gg, Gg, Gg, Gg, Gg, Gg, Gg, Gg, Gg, Gg, Gg, Gg, Gg, Gg, Gg, Gg, Gg, Gg, Gg, Gg, Gg, Gg, Gg, Gg, Gg, Gg, Gg, Gg, Gg, Gg, Gg, Gg, Gg, Gg, Gg, Gg, Gg, Gg, Gg, Gg, Gg, Gg, Gg, Gg, Gg, Gg, Gg, Gg, Gg, Gg, Gg, Gg, Gg, Gg, Gg, Gg, Gg, Gg, Gg, Gg, Gg, Gg, Gg, Gg, Gg
Gg, Gg, Gg, Gg, Gg, Gg, Gg, Gg, Gg, Gg, Gg, Gg, Gg, Gg, Gg, Gg, Gg, Gg, Gg, Gg, Gg, Gg, Gg, Gg, Gg, Gg, Gg, Gg, Gg, Gg, Gg, Gg, Gg, Gg, Gg, Gg, Gg, Gg, Gg, Gg, Gg, Gg, Gg, Gg, Gg, Gg, Gg, Gg, Gg, Gg, Gg, Gg, Gg, Gg, Gg, Gg, Gg, Gg, Gg, Gg, Gg, Gg, Gg, Gg, Gg, Gg, Gg, Gg, Gg, Gg, Gg, Gg, Gg, Gg, Gg, Gg, Gg, Gg, Gg, Gg, Gg, Gg, Gg, Gg, Gg, Gg, Gg
Gg, Gg, Gg, Gg, Gg, Gg, Gg, Gg, Gg, Gg, Gg, Gg, Gg, Gg, Gg, Gg, Gg, Gg, Gg, Gg, Gg, Gg, Gg, Gg, Gg, Gg, Gg, Gg, Gg, Gg, Gg, Gg, Gg, Gg, Gg, Gg, Gg, Gg, Gg, Gg, Gg, Gg, Gg, Gg, Gg, Gg, Gg, Gg, Gg, Gg, Gg, Gg, Gg, Gg, Gg, Gg, Gg, Gg, Gg, Gg, Gg, Gg, Gg, Gg, Gg, Gg, Gg, Gg, Gg, Gg, Gg, Gg, Gg, Gg, Gg, Gg, Gg, Gg, Gg, Gg, Gg, Gg, Gg, Gg, Gg, Gg, Gg
